0 0 0 0 0 0 0 0 0 0 0 0 0 0 0 5 5 5 5 5	
0 0 0 0 0 0 0 0 0 0 0 0 0 5 5 5 5 5 5 5 	
0 2 2 0 0 0 0 0 0 0 0 0 5 0 0 5 5 5 5 5       
0 0 2 2 0 0 0 0 0 0 0 0 0 0 0 5 5 5 5 5 
0 0 0 0 0 2 2 2 2 0 0 0 0 0 5 0 0 5 0 0 
0 0 0 0 0 0 0 0 2 2 2 2 0 5 0 0 0 5 0 0  
0 0 0 0 0 0 0 0 0 0 2 2 0 0 0 0 0 0 0 0 
0 0 0 0 0 0 0 0 0 0 0 0 0 0 0 0 0 0 0 0  
0 0 0 0 2 2 0 0 0 0 0 0 0 0 0 0 0 0 0 0 
0 0 0 0 0 2 2 0 0 0 0 0 0 0 0 0 0 2 2 2 
0 0 0 0 0 0 0 0 1 0 0 0 0 0 0 0 0 0 0 0 
0 0 0 0 0 0 2 1 1 1 0 0 0 0 0 0 0 0 0 0 		
0 0 0 0 0 0 1 1 1 1 1 0 0 0 0 0 0 0 0 0	
0 0 0 0 0 1 1 1 1 1 1 1 0 0 0 0 0 0 0 0		
0 0 0 0 1 1 1 1 1 1 1 1 1 0 0 0 0 0 0 0			
0 0 0 1 1 8 8 8 8 1 1 1 1 1 0 0 0 0 0 0		
0 0 1 1 1 8 1 1 8 1 1 1 1 1 1 0 0 0 0 0		
0 0 8 8 8 8 1 1 8 1 1 1 1 1 1 1 0 0 9 1		
1 1 1 1 1 1 1 1 8 1 1 1 1 1 1 1 1 1 1 8	
1 1 1 1 1 1 1 8 7 1 1 1 1 1 1 1 1 8 8 1