4 4 4 4 4 4 4 4 4 4 4 4 4 4 4 4 4 4 4 7
4 4 4 4 4 4 4 4 4 4 4 4 4 4 4 4 4 4 4 1
4 4 4 4 4 4 4 4 4 4 4 4 4 4 4 4 4 4 1 4
4 4 4 4 4 4 4 4 4 4 4 4 4 4 4 4 4 4 1 4
4 4 4 4 4 4 4 4 4 4 4 4 4 4 4 4 4 1 1 4
4 4 4 4 4 4 4 4 4 4 4 4 4 4 4 4 4 1 4 4
4 4 2 2 4 2 4 4 4 2 4 4 4 4 4 4 4 1 4 4
1 4 4 4 1 4 1 1 4 4 1 1 1 1 1 1 1 1 4 4
1 1 4 4 4 4 4 4 4 4 4 4 4 4 4 4 4 4 4 4
1 4 4 4 4 4 4 4 4 4 4 4 4 4 4 4 4 4 4 4
1 4 4 4 4 4 4 4 4 4 4 4 4 4 4 4 4 4 4 4
1 1 4 4 4 4 4 4 4 4 4 4 4 4 4 4 4 4 4 4
1 4 4 4 4 4 4 4 4 2 4 4 4 4 4 4 4 4 4 1
1 4 4 4 4 4 4 4 4 4 4 4 4 4 4 4 4 4 4 1
1 1 1 1 1 1 1 1 4 4 4 1 1 1 1 1 1 1 4 1
4 4 4 4 4 4 4 4 4 4 4 4 4 4 4 4 4 4 4 1
4 4 9 4 4 4 4 4 4 4 4 4 4 4 4 4 4 4 4 1
4 4 4 4 4 4 4 4 4 4 4 4 4 4 4 4 4 1 1 1
1 1 1 1 1 1 4 4 1 1 4 1 1 1 4 4 4 1 1 1
1 1 1 1 1 1 1 1 1 1 1 1 1 1 1 1 1 1 1 1