6 6 6 6 6 6 6 6 6 6 6 6 6 1 1 1 1 1 1 1
1 8 8 7 8 8 8 8 8 8 8 8 8 8 8 8 8 8 8 1 	
1 8 8 1 1 1 1 1 1 1 1 1 1 1 1 8 8 8 8 1       
6 8 8 8 8 8 8 8 8 8 8 8 8 8 8 8 8 8 8 1 
6 8 8 8 8 8 8 8 8 8 8 8 8 8 8 1 8 8 8 1 
1 8 8 8 8 8 8 8 8 8 8 8 8 8 8 8 8 8 8 1  
1 8 8 8 8 8 8 8 8 8 8 8 8 8 8 8 8 1 8 1 
6 8 8 8 8 8 8 8 8 8 8 8 8 8 8 8 8 8 1 1  
1 8 8 8 8 8 1 8 8 8 1 1 1 1 1 1 1 1 1 1 
1 8 8 8 8 8 8 8 8 8 8 8 8 8 8 8 8 8 8 1 
1 8 8 8 8 8 8 8 8 8 8 8 8 8 8 8 8 8 8 1 
1 8 8 8 1 8 8 8 8 8 8 8 8 8 8 8 8 8 8 1 		
1 8 8 8 8 8 1 8 8 1 8 1 8 1 8 8 8 8 8 1	
1 8 8 8 8 8 8 8 8 8 8 8 8 8 8 8 8 8 8 1		
1 8 8 8 8 8 8 8 8 8 8 8 8 8 8 8 8 8 8 1			
1 8 8 8 8 8 8 8 8 8 8 8 8 8 8 1 8 8 8 1		
1 8 9 8 8 8 8 8 8 8 8 8 8 8 8 8 8 8 8 1		
1 8 8 8 8 8 8 8 8 8 8 8 8 8 1 8 8 8 6 1		
1 1 1 1 1 1 8 8 8 8 8 1 1 1 1 1 1 1 1 1	
1 1 1 1 1 1 1 1 1 1 1 1 1 1 1 1 1 1 1 1