8 8 8 8 8 1 8 8 1 8 8 8 8 1 8 8 8 8 1 8
8 8 8 8 8 1 8 8 1 8 8 8 8 1 8 8 8 8 1 8
8 8 8 8 8 6 8 8 6 8 8 8 8 6 8 8 8 8 6 8
8 8 8 8 8 1 8 8 4 8 8 8 8 4 8 8 8 8 4 8
8 8 8 8 8 1 8 8 4 8 8 8 8 4 8 8 8 8 4 7
8 8 8 8 8 1 8 8 4 8 8 8 8 4 8 8 8 8 4 8
8 8 8 8 8 1 8 8 4 8 8 8 8 4 8 8 8 8 1 8
8 8 8 8 8 1 8 8 4 8 8 8 8 4 8 8 8 8 4 8
8 8 8 8 8 1 8 8 4 8 8 8 8 4 8 8 8 8 4 8
8 8 8 8 8 4 8 8 4 8 8 8 8 4 8 8 8 8 1 8
8 8 8 8 8 4 8 8 4 8 8 8 8 4 8 8 8 8 4 8
8 8 9 8 8 4 8 8 4 8 8 8 8 4 8 8 8 8 4 8
8 8 8 8 8 4 8 8 4 8 8 8 8 4 8 8 8 8 1 8
8 8 8 8 8 1 8 8 4 8 8 8 8 4 8 8 8 8 4 8
8 8 8 8 8 1 8 8 4 8 8 8 8 4 8 8 8 8 4 8
8 1 1 1 8 1 8 8 4 8 8 8 8 4 8 8 8 8 1 8
8 8 1 8 8 1 8 8 4 8 8 8 8 4 8 8 8 8 4 8
8 8 1 8 8 1 8 8 4 8 8 8 8 4 8 8 8 8 4 8
8 8 1 8 8 1 8 8 1 8 8 8 8 4 8 8 8 8 1 8
8 8 1 8 8 1 8 8 1 8 8 8 8 1 8 8 8 8 1 8