6 6 8 8 7 7 7 7 7 7 7 7 7 7 7 7 8 8 6 6
6 8 8 2 2 2 2 2 2 2 2 1 2 2 2 2 2 8 8 6
6 6 8 8 2 2 2 2 2 2 2 2 1 2 2 2 8 8 6 6
6 6 6 8 8 2 2 2 2 2 2 2 2 1 2 8 8 6 6 6
6 6 8 8 2 2 2 2 2 2 2 2 2 2 4 2 2 8 6 6
6 8 8 2 2 2 2 2 2 2 2 2 2 2 2 1 2 8 8 6
6 6 8 8 2 2 2 2 2 2 2 2 2 2 1 2 8 8 6 6
6 6 6 8 8 2 2 2 2 2 2 2 2 1 2 8 8 6 6 6
6 6 8 8 2 2 2 2 2 2 2 2 1 2 2 2 8 8 6 6
6 8 8 2 2 2 2 2 2 2 2 1 2 2 2 2 2 8 8 6
6 6 8 8 2 2 2 2 2 2 1 2 2 2 2 2 8 8 6 6
6 6 6 8 8 2 2 2 2 1 2 2 2 2 2 8 8 6 6 6
6 6 8 8 2 2 2 2 1 2 2 2 2 2 2 2 8 8 6 6
6 8 8 2 2 2 2 1 2 2 2 2 2 2 2 2 2 8 8 6
6 6 8 8 2 2 4 2 2 2 2 2 2 2 2 2 8 8 6 6
6 6 6 8 8 1 2 2 2 2 2 2 2 2 2 8 8 6 6 6
6 6 8 8 2 2 1 2 2 2 2 2 2 2 2 2 8 8 6 6
6 8 8 2 2 2 2 1 2 2 2 2 2 2 2 2 2 8 8 6
6 6 8 8 2 2 2 2 1 9 2 2 2 2 2 2 8 8 6 6
6 6 6 8 8 2 2 2 2 1 2 2 2 2 2 8 8 6 6 6