8 8 8 8 8 8 8 8 8 8 8 8 8 8 8 8 8 8 8 1
6 8 8 1 8 8 8 8 8 8 8 8 8 8 8 8 8 8 8 1	
6 8 8 1 1 8 8 8 8 8 8 8 8 8 8 8 8 8 8 1      
6 8 8 1 8 8 8 8 8 8 8 8 8 8 8 8 8 8 8 1
6 8 8 1 8 8 8 8 8 8 8 8 8 8 8 8 8 8 8 1
6 8 8 1 1 8 8 8 8 8 8 8 8 8 8 8 8 8 8 1 
6 8 8 1 8 8 8 8 8 8 8 8 8 8 8 8 8 8 8 1
6 8 8 1 8 1 8 8 1 8 8 1 8 8 8 8 8 8 8 1 
6 8 8 1 8 8 8 8 8 8 8 8 8 1 8 8 8 8 8 1
6 8 8 1 8 8 8 8 8 8 8 8 8 8 8 8 8 8 8 1
6 8 8 1 8 8 8 8 8 1 8 1 8 8 8 8 8 8 8 1
6 8 8 1 8 8 8 8 8 8 8 8 8 8 8 8 8 8 8 1		
6 8 8 1 8 8 8 8 1 8 8 8 8 8 8 8 8 8 8 1
6 8 8 1 8 8 8 8 8 8 8 8 8 8 8 8 8 8 8 1	
6 8 8 1 8 8 8 8 8 8 8 8 8 8 8 8 8 8 8 1
6 8 8 1 8 8 8 8 1 8 8 8 8 8 8 8 8 8 8 1	
6 8 8 1 1 8 1 8 8 8 8 8 8 8 8 8 8 8 8 1
6 8 8 1 8 8 8 8 8 8 8 8 8 8 8 8 8 8 8 1
6 7 8 1 8 8 8 8 8 8 8 8 8 8 8 8 8 9 8 1
6 8 1 1 1 1 1 1 1 1 1 1 1 1 1 1 1 1 1 1