3 3 3 3 3 3 3 3 3 3 3 3 3 3 3 3 3 3 3 3	
3 3 3 3 3 3 3 3 3 3 3 3 2 3 3 2 3 2 7 3	
3 3 3 3 3 3 3 3 3 3 3 3 1 3 3 1 3 1 3 3	
3 3 3 3 3 3 3 3 3 3 3 3 3 3 3 3 3 3 3 3	
3 3 3 3 3 3 3 3 2 3 3 3 3 3 3 3 3 3 3 3	
3 3 3 3 3 3 3 3 1 3 3 3 3 3 3 3 3 3 3 3	
3 3 3 3 2 3 3 3 3 3 3 3 3 3 3 3 3 3 3 3	
3 3 3 3 1 2 3 3 3 3 3 3 3 3 3 3 3 3 3 3	
3 3 3 3 3 1 3 3 3 3 3 3 3 3 3 3 3 3 3 3	
3 3 3 3 3 3 3 3 3 3 3 3 3 3 3 3 3 3 3 3	
3 3 3 3 3 3 3 2 3 3 3 3 3 3 3 3 3 3 3 3	
3 3 3 3 3 3 3 1 3 3 3 3 3 3 3 3 3 3 3 3 	
3 3 3 3 3 3 3 3 2 3 3 3 3 3 3 3 3 3 3 3
3 3 3 3 3 3 3 3 1 3 3 2 3 3 3 3 3 3 3 3	
3 3 3 3 3 3 3 3 3 3 3 1 3 3 3 3 3 3 3 3	
3 3 3 3 3 3 3 3 3 3 3 3 3 3 3 3 3 3 3 3		
3 3 3 3 3 3 3 3 3 3 3 3 2 3 3 3 3 3 3 3	
3 2 3 3 3 3 3 3 3 3 3 3 1 3 3 3 3 3 3 3
1 9 1 1 1 1 1 1 1 1 1 1 1 1 1 1 1 1 1 1	
1 1 1 1 1 1 1 1 1 1 1 1 1 1 1 1 1 1 1 1