1 0 0 0 0 0 0 0 0 0 0 0 0 0 0 5 5 9 5 5	
1 0 1 1 1 1 1 1 1 1 1 1 1 1 1 1 1 1 1 1
1 2 2 0 0 0 0 0 0 0 0 0 5 0 0 5 5 5 5 1  
1 1 1 1 1 1 1 1 1 1 1 1 1 1 1 1 1 1 0 1
1 0 0 0 0 2 2 2 2 0 0 0 0 0 5 0 0 5 0 1 
1 0 1 1 1 1 1 1 1 1 1 1 1 1 1 1 1 1 1 1
1 0 0 0 0 0 0 0 0 0 2 2 0 0 0 0 0 0 0 1 
1 1 1 1 1 1 1 1 1 1 1 1 1 1 1 1 1 1 0 1 
1 0 0 0 2 2 0 0 0 0 0 0 0 0 0 0 0 0 0 1 
1 0 1 1 1 1 1 1 1 1 1 1 1 1 1 1 1 1 1 1
1 0 0 0 0 0 0 0 0 0 0 0 0 0 0 0 0 0 0 1 
1 1 1 1 1 1 1 1 1 1 1 1 1 1 1 1 1 1 0 1		
1 0 0 0 0 0 0 0 0 0 0 0 0 0 0 0 0 0 0 1	
1 0 1 1 1 1 1 1 1 1 1 1 1 1 1 1 1 1 1 1	
1 0 0 0 0 0 0 0 0 0 0 0 0 0 0 0 0 0 0 1			
1 1 1 1 1 1 1 1 1 1 1 1 1 1 1 1 1 1 0 1	
1 0 0 0 0 0 0 0 0 0 0 0 0 0 0 0 0 0 0 1		
1 0 1 1 1 1 1 1 1 1 1 1 1 1 1 1 1 1 1 1	
1 0 0 0 0 0 0 0 0 0 0 0 0 0 0 0 0 0 0 1
1 1 1 1 1 1 1 1 1 1 1 1 1 1 1 1 1 1 7 1