8 8 8 8 8 8 6 8 8 8 8 8 8 8 8 8 8 8 8 8	
8 8 8 8 8 8 6 8 8 8 8 8 8 8 8 8 8 8 8 8 	
8 8 8 8 8 8 6 8 8 8 8 8 8 8 8 8 8 8 8 8       
8 8 8 8 8 8 6 8 8 8 8 8 8 8 8 8 8 8 8 8 
8 8 8 8 8 8 6 8 8 8 8 8 8 8 8 8 8 8 8 8 
8 8 8 8 8 8 6 8 8 8 8 8 8 8 8 8 8 8 8 8  
8 8 8 8 8 8 8 8 8 8 8 8 8 8 8 8 8 8 8 8 
8 8 8 8 8 8 8 8 8 6 8 8 6 6 8 8 8 8 8 8  
8 8 8 8 8 1 1 1 1 1 1 1 1 1 1 1 1 1 1 8 
8 8 8 8 8 6 8 8 8 8 8 8 8 8 8 8 8 8 8 8 
8 8 1 8 8 6 8 8 8 8 8 8 8 8 8 8 8 8 8 8 
8 8 8 8 8 6 8 8 8 8 8 8 8 8 8 8 8 8 8 8 	
1 8 8 8 8 6 8 8 8 8 8 8 8 8 8 8 8 8 8 8		
8 8 8 8 8 6 8 8 8 8 8 8 8 8 8 8 8 8 8 8		
8 1 8 8 8 6 8 8 8 8 8 8 8 8 8 8 8 8 8 8		
8 8 8 8 8 6 8 8 8 6 8 8 6 8 8 6 8 8 8 1
8 8 8 8 8 6 8 8 1 6 1 1 6 1 1 1 1 1 1 1
8 8 8 1 8 6 8 8 1 1 6 6 6 6 6 6 6 6 7 1
8 9 8 8 8 6 6 8 8 8 8 8 8 8 8 8 8 8 8 1	
1 1 1 1 1 1 1 1 1 1 1 1 1 1 1 1 1 1 1 1