0 0 9 0 0 0 0 0 0 0 0 0 0 0 0 4 4 4 4 4
1 1 1 1 1 1 1 4 1 1 1 1 1 1 1 1 1 1 1 1 	
1 1 4 4 4 4 4 4 4 4 4 4 1 1 1 1 1 1 1 1 	
1 1 4 1 1 1 1 1 1 1 1 1 1 1 1 1 4 4 4 4 	
1 1 4 4 4 4 4 4 4 4 4 4 4 4 4 4 4 1 1 4 	
1 1 1 4 4 1 1 1 1 1 1 1 1 1 4 1 1 1 1 4 	
4 4 4 1 1 4 4 4 4 4 4 4 4 4 4 1 1 1 1 4 	
4 1 4 4 4 4 1 1 1 1 1 1 1 1 1 1 1 1 1 4 	
4 4 1 1 1 1 4 4 4 1 1 1 1 1 1 1 1 1 1 4 	
1 4 4 1 1 1 4 1 4 1 1 1 1 1 1 1 1 1 1 4 	
1 1 4 4 4 4 4 1 4 4 4 1 1 4 4 4 4 4 4 4 	
1 1 1 1 1 1 1 1 1 1 4 4 4 4 1 1 1 4 1 4 	
1 1 1 1 1 1 1 1 1 1 1 1 1 1 1 4 4 4 1 4 	
1 1 4 4 4 4 4 4 4 4 4 4 4 4 4 4 1 1 1 4 	
1 1 4 1 1 1 1 1 1 1 1 1 1 1 1 1 1 1 1 4 	
1 1 4 4 4 1 4 4 4 1 4 4 4 1 4 4 4 1 1 4 	
1 1 1 1 4 4 4 1 4 4 4 1 4 4 4 1 4 4 1 4 	
1 1 1 1 1 1 1 1 1 1 1 1 1 1 1 1 1 4 1 4 	
1 4 4 4 4 4 4 4 4 4 4 4 4 4 4 4 4 4 4 4 	
1 7 1 1 1 1 1 1 1 1 1 1 1 1 1 1 1 1 1 4