0 0 0 0 0 0 0 0 0 0 0 0 0 0 0 6 7 5 5 5		
4 4 4 4 4 4 4 4 4 4 4 1 4 4 4 6 4 4 4 4 	
0 2 2 0 0 0 0 0 0 0 0 0 5 0 0 6 2 5 5 5 	
4 4 4 4 4 4 4 4 4 4 1 4 4 4 4 4 1 4 4 4 
0 0 0 0 0 2 2 2 2 0 0 0 0 0 5 0 2 5 0 0 	
4 4 4 4 4 4 4 4 4 1 4 4 4 4 4 4 1 4 4 4  
0 0 0 0 0 0 0 0 0 0 2 2 0 0 0 0 2 0 0 0 	
4 4 4 4 4 4 4 4 1 4 4 4 4 4 4 4 1 4 4 4  
0 0 0 0 2 2 0 0 0 0 0 0 0 0 0 0 2 0 0 0 	
4 4 4 4 4 4 4 1 4 4 4 4 4 4 4 4 1 4 4 4 
0 0 0 0 0 0 0 0 0 0 0 0 0 0 0 0 2 0 0 0 	
4 4 4 4 4 4 1 4 4 4 4 4 4 4 4 4 1 4 4 4 	
0 0 0 0 0 0 0 0 0 0 0 0 0 0 0 0 2 0 0 0	
4 4 4 4 4 1 4 4 4 4 4 4 4 4 4 4 1 4 4 4 
0 0 0 0 0 0 0 0 0 0 0 0 0 0 0 0 2 0 0 0 	
4 4 4 4 1 4 4 4 4 4 4 4 4 4 4 4 1 4 4 1 	
0 0 0 0 0 0 0 0 0 0 0 0 0 0 0 0 2 0 0 1 	
4 4 4 1 4 4 4 4 4 4 4 4 4 4 1 1 1 1 1 1 
0 9 0 0 0 0 0 0 0 0 0 0 0 0 0 0 0 0 0 0
0 1 0 0 0 0 0 0 0 0 0 0 0 0 0 0 0 0 0 0