2 7 2 2 2 2 2 2 2 2 2 2 2 2 2 2 2 2 2 2	
0 0 1 0 2 0 0 1 0 0 2 2 1 0 0 0 1 0 2 2 		
0 0 0 0 0 0 0 0 0 0 0 0 4 0 0 0 0 0 0 0		
0 0 0 0 0 0 0 0 0 0 0 0 4 0 0 0 0 0 0 0		
0 0 0 0 0 0 0 0 0 0 0 0 4 0 0 0 6 1 0 0		
0 0 0 0 0 0 0 0 1 6 0 0 4 0 0 0 0 0 0 0		
0 0 0 0 0 0 0 1 6 0 0 1 1 4 4 1 0 0 0 0 
0 0 0 0 0 0 0 0 0 0 0 0 6 6 6 0 0 0 0 0		
0 0 0 0 0 0 0 0 0 0 0 0 0 0 0 0 0 0 0 0		
0 0 0 0 1 0 0 0 0 0 0 0 0 0 0 0 0 0 0 0 
0 0 0 0 0 0 0 0 0 0 0 0 0 0 0 0 0 0 0 0		
0 0 0 0 0 0 0 0 0 1 0 0 0 0 0 0 0 0 0 0		
0 0 0 0 0 0 0 0 0 6 6 0 1 0 0 0 0 0 0 0	
0 0 0 0 0 0 0 0 0 0 0 6 0 0 0 0 0 0 0 0		
0 0 0 0 0 0 0 0 0 0 0 0 0 0 0 1 0 0 0 0			
0 0 0 0 0 0 0 0 0 0 0 0 0 0 0 0 0 0 0 0		
0 0 0 0 0 0 0 0 1 0 0 0 1 0 0 0 0 0 0 0		
0 0 0 0 1 0 0 0 6 0 0 0 0 6 0 0 0 0 0 0		
0 9 0 0 6 0 0 0 0 0 0 0 0 0 0 0 0 0 0 0	
0 1 0 0 0 0 0 0 0 0 1 1 0 0 0 0 0 0 0 0