0 0 0 0 0 0 0 0 0 0 0 0 0 0 0 5 5 5 5 5	
0 0 0 0 0 0 0 0 0 0 0 0 0 5 5 5 5 5 5 5 	
0 2 2 0 0 0 0 0 0 0 0 0 5 0 0 5 5 5 5 5       
0 0 2 2 0 0 0 0 0 0 0 0 0 0 0 5 5 5 5 5 
0 0 0 0 0 2 2 2 2 0 0 0 0 0 5 0 0 5 0 0 
0 0 0 0 0 0 0 0 2 2 2 2 0 5 0 0 0 5 0 0  
0 0 0 0 0 0 0 0 0 0 2 2 0 0 0 0 0 0 0 0 
0 0 0 0 0 0 0 0 0 0 0 0 0 0 0 0 0 0 0 0  
0 0 0 0 2 2 0 0 0 0 0 0 0 0 0 0 0 0 0 0 
0 0 0 0 0 2 2 0 0 0 0 0 0 0 0 0 0 2 2 2 
0 0 0 0 0 0 6 0 0 0 0 6 0 0 0 0 0 0 0 0 
0 9 0 0 0 0 6 2 0 1 0 0 0 0 0 0 0 0 0 7 	
1 1 1 1 1 1 1 1 1 1 1 1 1 1 1 1 1 4 1 1		
1 1 1 1 1 1 1 1 1 1 1 1 1 1 1 1 1 4 1 1		
1 1 1 1 1 1 1 1 1 1 1 1 1 1 1 1 1 4 1 1		
1 1 1 1 1 1 1 1 1 1 1 1 1 1 1 1 1 4 1 1		
1 1 1 1 1 1 1 1 1 1 1 1 1 1 1 1 1 4 1 1		
1 1 1 1 1 4 4 4 4 4 4 4 4 4 4 4 4 4 4 1		
1 1 1 1 1 7 1 1 1 1 1 1 1 1 1 1 1 1 1 1	
1 1 1 1 1 1 1 1 1 1 1 1 1 1 1 1 1 1 1 1