0 0 0 0 0 0 0 0 0 0 0 0 0 0 0 5 5 5 5 5	
0 0 0 0 0 0 0 0 0 0 0 0 0 5 5 5 5 5 5 5 	
0 2 2 0 1 0 0 0 1 0 0 0 5 1 1 5 5 5 5 5       
0 0 2 2 0 0 0 0 0 0 0 0 0 0 0 5 5 5 5 5 
0 0 0 0 0 2 2 2 2 0 0 0 0 0 5 0 0 5 0 0 
0 0 1 0 0 0 0 0 2 2 2 2 0 5 0 0 0 5 0 0  
0 0 0 0 0 0 0 0 0 0 2 2 0 0 0 0 0 0 0 0 
0 0 0 0 0 0 0 0 0 0 0 0 0 0 0 0 0 0 0 0  
0 0 0 1 2 2 0 0 0 0 0 0 0 0 0 0 0 0 0 0 
0 0 0 0 0 2 2 0 0 0 0 0 0 0 0 0 0 2 2 2 
0 0 0 0 0 0 0 0 0 0 0 0 0 0 0 0 0 0 0 0 
0 0 1 0 0 0 2 2 0 0 0 0 0 0 0 0 0 0 0 0 	
0 0 0 0 0 0 0 0 0 0 0 0 6 0 0 6 6 0 0 0		
0 0 0 0 0 0 0 0 0 0 0 0 6 0 0 6 6 6 0 0		
0 0 0 1 0 0 0 0 0 0 0 0 6 0 0 0 7 6 0 0		
0 0 0 0 0 0 0 0 0 0 0 0 6 1 1 1 6 6 0 0		
0 0 0 0 0 0 0 0 0 0 0 0 6 6 6 6 0 0 0 0		
9 0 1 0 0 0 0 0 0 0 0 0 0 6 6 0 0 0 0 0	
1 1 1 6 6 6 6 6 6 6 6 6 6 6 6 6 6 6 6 6
1 1 1 1 1 1 1 1 1 1 1 1 1 1 1 1 1 1 1 1 